Level 6
8 11
+++++++++  
+    +  +++
+ ++   #  +
+  # + #  +
+  #W# +**+
+ ++ +#+**+
+      +**+
+++++++++++