Level 3
9 10
++++++++++
+   ++   +
+  # + * +
+    ++  +
++ ++++ ++
+        +
+   +++  +
+   W    +
++++++++++