Level 4
6 9
  ++++   
+++  ++++
+     # +
+ +  +# +
+ * *+W +
+++++++++